10
10
0000000000-
0001111000-
0001001000-
0000000000-
0001111000-
0001111000-
0000000000-
0001001000-
0001111000-
0000000000-